Content-Type: text/x-zim-wiki
Wiki-Format: zim 0.4

====== Typography ======

===== tran =====
package: ''tran''

''echo hello world | tran bold''

'''
tran 1 2>&1 | sed 1d | while read key; do echo "hello world" | tran $key | sed "s/^/$key: /"; done
armenian: Õ°Õ¥Õ¬Õ¬Õ¸ Ö‚Õ¸Ö€Õ¬Õ¤
ascii: hello world
bold: ğ¡ğğ¥ğ¥ğ¨ ğ°ğ¨ğ«ğ¥ğ
bold fraktur: ğ–ğ–Šğ–‘ğ–‘ğ–” ğ–œğ–”ğ–—ğ–‘ğ–‰
bold italic: ğ’‰ğ’†ğ’ğ’ğ’ ğ’˜ğ’ğ’“ğ’ğ’…
bold script: ğ“±ğ“®ğ“µğ“µğ“¸ ğ”€ğ“¸ğ“»ğ“µğ“­
circled: â“—â“”â“›â“›â“ â“¦â“â“¡â“›â““
cyrillic: Ñ…ÑĞ»Ğ»Ğ¾ Ğ»Ğ¾Ñ€Ğ»Ğ´
devanagari: à¤¹à¤à¤²à¤²à¤“ à¤µà¤“à¤°à¤²à¤¦
double-struck: ğ•™ğ•–ğ•ğ•ğ•  ğ•¨ğ• ğ•£ğ•ğ••
fraktur: ğ”¥ğ”¢ğ”©ğ”©ğ”¬ ğ”´ğ”¬ğ”¯ğ”©ğ”¡
fullwidth: ï½ˆï½…ï½Œï½Œï½ã€€ï½—ï½ï½’ï½Œï½„
futhark: ášºá›–á›šá›šá›Ÿ áš¹á›Ÿáš±á›šá›
georgian: áƒ°áƒ”áƒšáƒšáƒ áƒ³áƒáƒ áƒšáƒ“
gothic: ğŒ·ğŒ´ğŒ»ğŒ»ğ‰ ğ…ğ‰ğ‚ğŒ»ğŒ³
greek: Ï‡ÎµÎ»Î»Î¿ Ï…Î¿ÏÎ»Î´
hangul: í—¬lì˜¤ wì˜¤rld
hiragana: ã¸llãŠ ã‚’rld
italic: â„ğ‘’ğ‘™ğ‘™ğ‘œ ğ‘¤ğ‘œğ‘Ÿğ‘™ğ‘‘
katakana: ãƒ˜llã‚ª ã‚¦ã‚©rld
latin: hello world
monospace: ğš‘ğšğš•ğš•ğš˜ ğš ğš˜ğš›ğš•ğš
mtavruli: áƒ°áƒ”áƒšáƒšáƒ áƒ³áƒáƒ áƒšáƒ“
negative circled: ğŸ…—ğŸ…”ğŸ…›ğŸ…›ğŸ… ğŸ…¦ğŸ…ğŸ…¡ğŸ…›ğŸ…“
negative squared: ğŸ…·ğŸ…´ğŸ…»ğŸ…»ğŸ…¾ ğŸ††ğŸ…¾ğŸ†ğŸ…»ğŸ…³
old italic: ğŒ‡ğŒ„ğŒ‹ğŒ‹ğŒ wğŒğŒ“ğŒ‹ğŒƒ
parenthesized: â’£â’ â’§â’§â’ª â’²â’ªâ’­â’§â’Ÿ
regional indicators: ğŸ‡­ğŸ‡ªğŸ‡±ğŸ‡±ğŸ‡´ ğŸ‡¼ğŸ‡´ğŸ‡·ğŸ‡±ğŸ‡©
sans-serif: ğ—ğ–¾ğ—…ğ—…ğ—ˆ ğ—ğ—ˆğ—‹ğ—…ğ–½
sans-serif bold: ğ—µğ—²ğ—¹ğ—¹ğ—¼ ğ˜„ğ—¼ğ—¿ğ—¹ğ—±
sans-serif bold italic: ğ™ğ™šğ™¡ğ™¡ğ™¤ ğ™¬ğ™¤ğ™§ğ™¡ğ™™
sans-serif italic: ğ˜©ğ˜¦ğ˜­ğ˜­ğ˜° ğ˜¸ğ˜°ğ˜³ğ˜­ğ˜¥
script: ğ’½â„¯ğ“ğ“â„´ ğ“Œâ„´ğ“‡ğ“ğ’¹
smallcaps: Êœá´‡ÊŸÊŸá´ á´¡á´Ê€ÊŸá´…
squared: ğŸ„·ğŸ„´ğŸ„»ğŸ„»ğŸ„¾ ğŸ…†ğŸ„¾ğŸ…ğŸ„»ğŸ„³
'''


===== banner =====
package: ''figlet''

'''
figlet hello
 _          _ _       
| |__   ___| | | ___  
| '_ \ / _ \ | |/ _ \ 
| | | |  __/ | | (_) |
|_| |_|\___|_|_|\___/ 
'''


'''
figlet -ptk -f slant hello
    __           __ __     
   / /_   ___   / // /____ 
  / __ \ / _ \ / // // __ \
 / / / //  __// // // /_/ /
/_/ /_/ \___//_//_/ \____/
'''
 

Font list: http://www.figlet.org/examples.html
